NO ./textures/north.xpm42
WE ./textures/west.xpm42
EA ./textures/east.xpm42
SO ./textures/south.xpm42
F 250,1,1
C 1,1,250

11111111111111111
10010000000000001
10000000000000001
10000000000000001
10000000000000001
10000000000000001
10000000000000001
10000000N00000001
10000000000000001
10000000000000001
10000000000000001
10000000000000001
10000000000000001
11111111111111111
