    NO./textures/north.xpm42
					SO ./textures/south.xpm42







                                               WE ./textures/west.xpm42
   EA ./textures/east.xpm42
F220,100,0
C 					255,30,213

 1111111111
10000E0001
100000011
1000000001
111111111
