    NO./coins.xpm
					SO ./coins.xpm







                                               WE ./coins.xpm
   EA ./coins.xpm
F220,100,0
C 					255,30,213

 111111111
10000000001
 100N0000001
  1000000001
  1111111111
