    NO./coins.xpm
					SO ./coins.xpm







                                               WE ./coins.xpm
   EA ./coins.xpm
F220,100,0
C 					255,30,213

111111111111
100000000001
101111111101
101      101
101111111101
100000000001
100111000111
1001 10001 1
1001 10001 1
1111 11111N1
