    NO./textures/wall.png
					SO ./coins.xpm







                                               WE ./coins.xpm
   EA ./coins.xpm
F220,100,0
C 					255,30,213

 1111111111
1000000001
10E000001
1000000001
111111111
