    NO./coins.xpm
					SO ./coins.xpm







                                               WE ./coins.xpm
   EA ./coins.xpm
F220,100,0
C 					255,30,213

 11111111
1000100001
101N100001
1010000001
111111111
