    NO./coins.xpm
					SO ./coins.xpm







                                               WE ./coins.xpm
   EA ./coins.xpm
F220,100,0
C 					255,30,213

11111111111
10000000N001
11111111111
