    NO./coins.xpm
					SO ./coins.xpm
                                               WE ./coins.xpm
   EA ./coins.xpm
F220,100,0
C 					1,30,111


          11111
          10001
          10001
          10001
          10001
          10001
1111111111100011111111111
1000000000000001000000001
1000000000100001000000001
100000000000000100000001
1000000000000000000000001
1000000000000000000000001
1000000000000000000000001
1000000000000000000000001
1N00000000000000000000001
1111111111111111111111111





